那個靜默的陽光午後	范瑋琪			
嗯	傅又宣			
Until The Day	林俊傑			
心動		JerryC	吳卓源	
動物世界	薛之謙			
下輩子	玖壹壹			
開不了口	周杰倫			
兜圈	林宥嘉			
不關你的事	八三夭			
皮囊	蕭敬騰			
我們的總和	艾怡良			
失憶的金魚	楊丞琳			
這是最後一次	謝和弦			
北風和太陽	黃鴻升			
慢慢喜歡你	莫文蔚			
分手後不要做朋友	文音梁			
光線背後	蕭敬騰			
好好愛個女孩	張信哲			
胖是一種罪	陳睿纁			
框不住的愛	王艷薇			
體面	于文文			
在幸福的路上	范瑋琪			
山海	草東沒有派對			
三角題	二珂			
我的事不關你的事	賴慈泓		孫盛希	
兩難	梁靜茹			
愛又愛	2	BY2		
等你下課	周杰倫		楊瑞代	
一直想著他	莊心妍			
幾分之幾	盧廣仲			
不需要知道	韋禮安			
爛泥	草東沒有派對			
成名在望	五月天			
謝謝收看	劉明湘			
稻香	周杰倫			
我愛你	曾沛慈			
念	胡夏			
美女與野獸	田馥甄			
Got Your Back	兄弟本色	GUTS		
大風吹	草東沒有派對			
That’s Alright	袁詠琳			
你和我	陳忻玥			
一起飆高音	黃明志		李佳薇	
跳舞的梵谷	孫燕姿			
丹寧執著	林俊傑		消除聯萌	
對的人	莊心妍			
其實我...（東森戲劇台韓劇《泡泡糖》片頭曲）	李建軒			
20		Ty	王心凌	
退後	周杰倫			
獨家記憶	陳小春			
搞砸	兄弟本色	GUTS		
一定會追到你	聖結石			
再遇不到你這樣的人	莊心妍			
自然の顏	梁文音			
連名帶姓		aMEI		
我繼續	林俊傑			
十年	陳奕迅			
眉飛色舞PLUS	鄭秀文八三夭			
小時候	小	S		
差一步	大壯			
斷訊	邱鋒澤黃偉晉			
聊傷	畢書盡			
I'm Burning	陳彥允			
越清醒越孤獨	信			
太陽	邱振哲			
因為曾經愛過	蔡佩軒			
任意門	五月天			
披風	陳奕迅			
沒離開過	張韶涵			
一諾千年	阿杜			
安靜	周杰倫			
還能擁抱	潘嘉麗			
到底		aMEI		
終於結束的起點	五月天			
牽心萬苦	謝和弦			
以分手為前提	戴愛玲			
愛無所畏	呂薔	Amuyi		
明天的秘密	蕭亞軒			
有太多人	高進			
船	林宥嘉			
追夢人	田馥甄			
返老還童	胡彥斌			JonyJ
You're Gone	畢書盡			
飄向北方		JasonChen		
辣台妹 HOT CHICK	頑童116	MJ116		
Nothing At All	畢書盡			
Better This Way	傅又宣			
聽見下雨的聲音	周杰倫			
誰來剪月光	陳奕迅			
Despacito 緩緩		LuisFonsi	林俊傑	
別問很可怕		JSheon		
算什麼男人	周杰倫			
不像話	呂薔	Amuyi		
小瓶子	林俊傑			
我們盡力了	黃致列			
黑夜問白天	林俊傑			
另一個結局	孫盛希			
言不由衷	徐佳瑩			
你的名字	陳零九			
再見我的愛	獅子合唱團			
最初來到世界的模樣	林芯儀			
Be Your Light	畢書盡			
凉凉	楊宗緯		張碧晨	
戒斷		aMEI		
我是冠軍	玖壹壹			
淘汰	陳奕迅			
什麼歌	五月天			
該忘的日子	郭靜			
你在身邊	庭竹		陳嘉唯	
星期三或禮拜三	魏如萱		馬頔	
風衣	孫燕姿			
如果我是你	邱鋒澤		吳心緹	
讓愛傳出去	蔡依林			
光		aMEI		
我們的愛	獅子合唱團			
微笑帶過	孫盛希			
O_LOVE	呂薔	Amuyi		
最久的瞬間	炎亞綸			
脫胎換骨	譚詠麟		五月天	
夫妻臉	田耕瑋與蕭小	M		
現在的你，好嗎?	鍾鎮宇			
慢慢習慣	劉德華			
了不起寂寞	戴愛玲			
星之所向	小球			
我喜歡上你時的内心活動	陳綺貞			
Better Believe Me	陳嘉唯		頑童116	MJ116
剪雲者	林俊傑			
我想你了	畢書盡			
畢竟深愛過	六哲			
未單身		ALin		
黏黏	周興哲	Eric	許瑋甯	
說實話	張簡君偉			
愛情轉移	陳奕迅			
壞的好人		aMEI		
皇后區的皇后	葛仲珊			
亮了	曾之喬			
猜猜看	曾之喬			
李白	李榮浩			
為你我受冷風吹	吳卓源			
最初的記憶	徐佳瑩			
I Love The Sky	蔡恩雨			
戒菸	李榮浩			
歌謠	李榮浩			
最後一首情歌	陳零九			
桃花諾	鄧紫棋	GEM		
擊敗人	黃明志			
之外	陳奕迅			
祝你幸福	李榮浩			
我看著你的時候	李榮浩			
脫罪 ACQUITTAL	頑童116	MJ116		
啪啪啪	黃明志			
現在就讓我走	宇宙人			
如初之光	莫文蔚			
很晚的晚安	孫盛希			
我不是神	方泂鑌阿鑌			
You'll Never Know		JSheon		
我不會	那對夫妻			
一直走		ALin		
我很愉快	孫燕姿			
鐵皮屋	兄弟本色	GUTS		
為你停留	小樂			
路人甲	呂薔	Amuyi		
我害怕	薛之謙			
一千零一個願望	楊丞琳			
什麼什麼	蔡依林			
貪圖	蔡健雅			
一步成詩	王詩安			
你說你愛我	蔡佩軒			
心之焰	鄧紫棋	GEM		
Costly Love	頑童116	MJ116		BlackDoe
根本沒愛過	潘瑋柏			
買榜	熊仔		吳卓源	
幸褔路上	蔡依林			
我們不一樣	大壯			
慣性取暖	小宇宋念宇			
愛如空氣	韋禮安			
那對夫妻	那對夫妻			
根本就不會再見面	聖結石			
裝醉		aMEI		
不放	周湯豪			
多遠都要在一起	鄧紫棋	GEM		
灰色	徐佳瑩			
頑固	五月天			
走到飛	熊仔		大支	
我說寶貝	阿達		黃路梓茵	
嘻哈庄腳情	玖壹壹		黃路梓茵	
偉大的渺小	林俊傑			
我愛過你	周興哲	Eric		
光之海		ALin		
當你	田馥甄			
身旁	韋禮安			
愛情廢柴	周杰倫			
同在	小宇宋念宇			
把最甜的都給妳	兄弟本色	GUTS		
愛的就是你	劉佳			
關鍵詞	林俊傑			
安儷	聖結石			
我的新衣		VAVA	王倩倩	
你說了算		aMEI	瘦子	
如果雨之後	周興哲	Eric		
快魚仔	盧廣仲			
偏愛	曾沛慈			
身後		aMEI		
就這樣	李榮浩			
幹大事 BIG THING	頑童116	MJ116		
偷故事的人		aMEI		
2030	頑童116	MJ116		
無窮	吳汶芳			
Coming Home	潘瑋柏			
一百種孤獨的理由	郭美美			
傲嬌		aMEI	艾怡良	
追光者	岑寧兒			
我多喜歡你，你會知道	王俊琪			
你離開他了嗎	曾沛慈			
剛好遇見你	李玉剛			
Turn up	周湯豪			
搖落	兄弟本色	GUTS		
真的不想嘴	聖結石		聖嫂	Dodo
啞巴	潘瑋柏			
凡人歌	五月天		蕭敬騰	
也可以	閻奕格			
泡沫	鄧紫棋	GEM		
家家酒	家家			
Will You Remember Me	李玖哲			
是他不配	孫盛希			
SPOTLIGHT	頑童116	MJ116		
晴天	周杰倫			
青春住了誰	楊丞琳			
寂寞無害	艾怡良			
最笨的人是我	方泂鑌阿鑌			
告白氣球	周杰倫			
光年之外	鄧紫棋	GEM		
孤獨是會上癮的	吳克群			
魚仔	盧廣仲			
好好	五月天			
愛不需要裝乖	謝和弦		王詩安	
讓我留在你身邊	陳奕迅			
曖昧	薛之謙			
漂向北方	黃明志		王力宏	
如果我們不曾相遇	五月天			
SOUTH SIDE	頑童116	MJ116		
說散就散		JC		
不曾回來過	李千娜			
所謂的愛	小宇宋念宇			
愛．這件事情	傅又宣			
再見	鄧紫棋	GEM		
道聽塗說	林芯儀			
剛剛好	薛之謙			
你，好不好？	周興哲	Eric		
那些你很冒險的夢	林俊傑			
妮妮	那對夫妻			
年輪說	楊丞琳			
永不失聯的愛	周興哲	Eric		
好愛好散	陳勢安			
你還要我怎樣	薛之謙			
不該	周杰倫			aMEI
小幸運	田馥甄			
謝謝妳愛我	謝和弦			
醜八怪	薛之謙			
派對動物	五月天			
帥到分手	周湯豪			
在沒有你以後	謝和弦		張智成	
迷途羔羊	張震嶽		瘦子	
回憶那麼傷	孫子涵			
後來的我們	五月天			
FLY OUT	兄弟本色	GUTS		
是我不夠好	李毓芬			
演員	田馥甄			
大齡女子	彭佳慧			
不為誰而作的歌	林俊傑			
走著走著就散了	莊心妍			
可惜沒如果	林俊傑			
修煉愛情	林俊傑			
